111111110000111111111000111111111100111111110000111111111
111111110000111111111000111111111100111111110000111111111
111111110000111111111000111111111100111111110000111111111
111111110000111111111000111111111100111111110000111111111
111111110000111111111000111111111100111111110000111111111
111111110000111111111000111111111100111111110000111111111
111111110000111111111000111111111100111111110000111111111
111111110000111111111000111111111100111111110000111111111
000000000000111111111000111111111100000000000000111111111
000000000000000000000000111111111100000000000000111111111
000000000000000000000000000000000000000000000000000000000
000000000000000000000000000000000000000000000000000000000
111111110000111111110000111111110000111111100000111111100
111111110000111111110000111111110000111111100000111111100
111111110000111111110000111111110000111111100000111111100
111111110000111111110000111111110000111111100000111111100
111111110000111111110000111111110000111111100000111111100
111111110000111111110000111111110000111111100000111111100
111111110000111111110000111111110000111111100000111111100
111111110000111111110000111111110000000000000000000000000
000000000000000000000000000000000000000000000000000000000
000000000000000000000000000000000000000000000000000000000
000000000000000000000000000000000000000000000000000000000
000000000000000000000000000000000000000000000000000000000
111111110000111111111000111111100000111111111000111111111
111111110000111111111000111111100000111111111000111111111
111111110000111111111000111111100000111111111000111111111
111111110000111111111000111111100000111111111000111111111
111111110000111111111000111111100000111111111000111111111
111111110000111111111000111111100000111111111000111111111
111111110000111111111000111111100000111111111000111111111
111111110000111111111000000000000000111111111000111111111
000000000000111111111000000000000000111111111000111111111
000000000000000000000000000000000000000000000000111111111
000000000000000000000000000000000000000000000000000000000
000000000000000000000000000000000000000000000000000000000
111111110000111111111100111111110000111111100000111111111
111111110000111111111100111111110000111111100000111111111
111111110000111111111100111111110000111111100000111111111
111111110000111111111100111111110000111111100000111111111
111111110000111111111100111111110000111111100000111111111
111111110000111111111100111111110000111111100000111111111
111111110000111111111100111111110000111111100000111111111
111111110000111111111100111111110000000000000000111111111
000000000000111111111100000000000000000000000000111111111
000000000000111111111100000000000000000000000000000000000
000000000000000000000000000000000000000000000000000000000
000000000000000000000000000000000000000000000000000000000
111111110000111111100000111111100000111111100000111111110
111111110000111111100000111111100000111111100000111111110
111111110000111111100000111111100000111111100000111111110
111111110000111111100000111111100000111111100000111111110
111111110000111111100000111111100000111111100000111111110
111111110000111111100000111111100000111111100000111111110
111111110000111111100000111111100000111111100000111111110

x, y : 55, 57